**/////***//////***/////*****//***//***//////***//////****************
**//**//**//*******//**//****//***//***//*******//********************
**//**//**//////***//***//***//***//***//*******//////****************
**//**//**//*******//**//****//***//***//*******//********************
**/////***//////***/////*****///////***//////***//////****************
**********************************************************************